5
     -s-   D  ----s----       A
    w      D      h           A
     D h  p   h  B p          A
        h    w     h h        A
B   p h   c    Dw             A